  #####
###   #
#.o@  #
### @.#
#.##@ #
# # . ##
#@ %@@.#
#      ##########
#               #
#   .  ##########
########